"filename", "language", "C++", "comment", "blank", "total"
"c:\Users\askbl\School\Fontys\Semester 6\GLOW\Codebase\GLOW-II\ROLF - Master\src\AskButton\AskButton.cpp", "C++", 83, 6, 12, 101
"c:\Users\askbl\School\Fontys\Semester 6\GLOW\Codebase\GLOW-II\ROLF - Master\src\AskButton\AskButton.h", "C++", 28, 0, 8, 36
"c:\Users\askbl\School\Fontys\Semester 6\GLOW\Codebase\GLOW-II\ROLF - Master\src\main.cpp", "C++", 122, 14, 26, 162
"c:\Users\askbl\School\Fontys\Semester 6\GLOW\Codebase\GLOW-II\ROLF - Master\src\moduleManager\PuzzlePiece\PuzzlePiece.cpp", "C++", 51, 10, 9, 70
"c:\Users\askbl\School\Fontys\Semester 6\GLOW\Codebase\GLOW-II\ROLF - Master\src\moduleManager\PuzzlePiece\PuzzlePiece.h", "C++", 22, 2, 4, 28
"c:\Users\askbl\School\Fontys\Semester 6\GLOW\Codebase\GLOW-II\ROLF - Master\src\moduleManager\PuzzlePiece_Heart\PuzzlePiece_heart.cpp", "C++", 37, 11, 8, 56
"c:\Users\askbl\School\Fontys\Semester 6\GLOW\Codebase\GLOW-II\ROLF - Master\src\moduleManager\PuzzlePiece_Heart\PuzzlePiece_heart.h", "C++", 17, 0, 5, 22
"c:\Users\askbl\School\Fontys\Semester 6\GLOW\Codebase\GLOW-II\ROLF - Master\src\moduleManager\PuzzlePiece_Ledpipe\PuzzlePiece_Ledpipe.cpp", "C++", 37, 11, 8, 56
"c:\Users\askbl\School\Fontys\Semester 6\GLOW\Codebase\GLOW-II\ROLF - Master\src\moduleManager\PuzzlePiece_Ledpipe\PuzzlePiece_Ledpipe.h", "C++", 17, 0, 5, 22
"c:\Users\askbl\School\Fontys\Semester 6\GLOW\Codebase\GLOW-II\ROLF - Master\src\moduleManager\connectedModule\CompassConnector\CompassConnector.cpp", "C++", 38, 3, 7, 48
"c:\Users\askbl\School\Fontys\Semester 6\GLOW\Codebase\GLOW-II\ROLF - Master\src\moduleManager\connectedModule\CompassConnector\CompassConnector.h", "C++", 32, 0, 12, 44
"c:\Users\askbl\School\Fontys\Semester 6\GLOW\Codebase\GLOW-II\ROLF - Master\src\moduleManager\connectedModule\connectedModule.cpp", "C++", 71, 2, 10, 83
"c:\Users\askbl\School\Fontys\Semester 6\GLOW\Codebase\GLOW-II\ROLF - Master\src\moduleManager\connectedModule\connectedModule.h", "C++", 45, 0, 12, 57
"c:\Users\askbl\School\Fontys\Semester 6\GLOW\Codebase\GLOW-II\ROLF - Master\src\moduleManager\moduleManager.cpp", "C++", 129, 16, 20, 165
"c:\Users\askbl\School\Fontys\Semester 6\GLOW\Codebase\GLOW-II\ROLF - Master\src\moduleManager\moduleManager.h", "C++", 22, 0, 14, 36
"c:\Users\askbl\School\Fontys\Semester 6\GLOW\Codebase\GLOW-II\ROLF - Master\src\pipePieces.h", "C++", 23, 110, 18, 151
"c:\Users\askbl\School\Fontys\Semester 6\GLOW\Codebase\GLOW-II\ROLF - Master\src\setup.h", "C++", 15, 1, 9, 25
"Total", "-", 789, 186, 187, 1162