"filename", "language", "C++", "comment", "blank", "total"
"c:\Users\askbl\School\Fontys\Semester 6\GLOW\Codebase\GLOW-II\ROLF - Master\src\AskButton\AskButton.cpp", "C++", 83, 6, 12, 101
"c:\Users\askbl\School\Fontys\Semester 6\GLOW\Codebase\GLOW-II\ROLF - Master\src\AskButton\AskButton.h", "C++", 28, 0, 8, 36
"c:\Users\askbl\School\Fontys\Semester 6\GLOW\Codebase\GLOW-II\ROLF - Master\src\main.cpp", "C++", 145, 14, 34, 193
"c:\Users\askbl\School\Fontys\Semester 6\GLOW\Codebase\GLOW-II\ROLF - Master\src\moduleManager\connectedModule\connectedModule.cpp", "C++", 166, 12, 20, 198
"c:\Users\askbl\School\Fontys\Semester 6\GLOW\Codebase\GLOW-II\ROLF - Master\src\moduleManager\connectedModule\connectedModule.h", "C++", 72, 1, 22, 95
"c:\Users\askbl\School\Fontys\Semester 6\GLOW\Codebase\GLOW-II\ROLF - Master\src\moduleManager\moduleManager.cpp", "C++", 751, 244, 129, 1124
"c:\Users\askbl\School\Fontys\Semester 6\GLOW\Codebase\GLOW-II\ROLF - Master\src\moduleManager\moduleManager.h", "C++", 68, 0, 28, 96
"c:\Users\askbl\School\Fontys\Semester 6\GLOW\Codebase\GLOW-II\ROLF - Master\src\pipePieces.h", "C++", 26, 119, 22, 167
"c:\Users\askbl\School\Fontys\Semester 6\GLOW\Codebase\GLOW-II\ROLF - Master\src\setup.h", "C++", 16, 1, 10, 27
"Total", "-", 1355, 397, 285, 2037