"filename", "language", "C++", "comment", "blank", "total"
"c:\Users\askbl\School\Fontys\Semester 6\GLOW\Codebase\GLOW-II\ROLF - Master\src\AskButton\AskButton.cpp", "C++", 83, 6, 12, 101
"c:\Users\askbl\School\Fontys\Semester 6\GLOW\Codebase\GLOW-II\ROLF - Master\src\AskButton\AskButton.h", "C++", 28, 0, 8, 36
"c:\Users\askbl\School\Fontys\Semester 6\GLOW\Codebase\GLOW-II\ROLF - Master\src\main.cpp", "C++", 123, 14, 26, 163
"c:\Users\askbl\School\Fontys\Semester 6\GLOW\Codebase\GLOW-II\ROLF - Master\src\moduleManager\connectedModule\connectedModule.cpp", "C++", 89, 3, 16, 108
"c:\Users\askbl\School\Fontys\Semester 6\GLOW\Codebase\GLOW-II\ROLF - Master\src\moduleManager\connectedModule\connectedModule.h", "C++", 59, 0, 15, 74
"c:\Users\askbl\School\Fontys\Semester 6\GLOW\Codebase\GLOW-II\ROLF - Master\src\moduleManager\moduleManager.cpp", "C++", 228, 45, 46, 319
"c:\Users\askbl\School\Fontys\Semester 6\GLOW\Codebase\GLOW-II\ROLF - Master\src\moduleManager\moduleManager.h", "C++", 41, 0, 16, 57
"c:\Users\askbl\School\Fontys\Semester 6\GLOW\Codebase\GLOW-II\ROLF - Master\src\pipePieces.h", "C++", 27, 110, 19, 156
"c:\Users\askbl\School\Fontys\Semester 6\GLOW\Codebase\GLOW-II\ROLF - Master\src\setup.h", "C++", 15, 1, 9, 25
"Total", "-", 693, 179, 167, 1039